11110000000000000001
11100100000000000001
11000000000000000001
01000001100011000000
00000000000000000000
00000000000000000000
00000001110000000000
00000000000000000000
00000000000000000000
00001000000000000000
00000000000100000000
00001010000000000000
00000000100000000000
10000000000010000001
10000000000000000001
10000000000000100001
00000000100000000001
00000000000000000001
00000000001000000001